R 1080 640


NO ./textures/glass_green.png
SO ./textures/glass_magenta.png
WE ./textures/glass_orange.png
EA ./textures/glass_cyan.png
S ./textures/barrel.png

F 255, 0, 255
C 255, 255, 0


111111111111111111              
100000000000000001            111111111
100020000000000001      111111100000001
100000000011111111      100000000000001
100000000000000001111111100000000000001
100000000000000000000020000000001111111
100002000000000000S0000000111111
100000000000000001111111111 
10000000000111111
100000000000000001
10000000000111111
10000000000111111
10000000000111111
10000000000111111
10000000000111111
10000000000111111
10000000000111111
10000000000111111
10000000000111111
111111111111111001
111111111111111111
