R 1080 640


NO ./textures/snow.png
SO ./textures/polished_diorite.png
WE ./textures/polished_andesite.png
EA ./textures/packed_ice.png
S ./textures/barrel.png

F 31, 65, 71
C 224, 255, 255


111111111111111111111111111              
100000000000000000000000001            111111111
100020000000000000000000001      111111100000001
100000000000000000000000001      100000000000001
100000000000000000000000001111111100000000000001
100000000000000000000000000000020000000001111111
100002000000000000S00000000000000000111111
100000000000000000000000001111111111 
100000000000000000000000001
100000000000000000000000001
100000000000000000000000001
100000000000000000000000001
100000000000000000000000001
100000000000000000000000001
100000000000000000000000001
111111111111111111111111111
